,mun_name,mun_employed,male_employed,fem_employed,mun_1sector,male_1sector,fem_1sector,mun_2sector,male_2sector,fem_2sector,mun_3sector,male_3sector,fem_3sector,can_name,1,2,3,4,5,6,7,8,9,10,11,12
0,ENTLEBUCH,7549,5431,2118,2553,2080,473,2377,2050,327,2592,1289,1303,LUZERN,136645,91200,45445,15196,11857,3339,53596,43351,10245,66779,35314,31465
1,1001 DOPPLESCHWAND,205,166,39,78,73,5,64,60,4,62,32,30,LUZERN,136645,91200,45445,15196,11857,3339,53596,43351,10245,66779,35314,31465
2,1002 ENTLEBUCH,1481,1082,399,386,338,48,485,437,48,606,305,301,LUZERN,136645,91200,45445,15196,11857,3339,53596,43351,10245,66779,35314,31465
3,1003 ESCHOLZMATT,1354,962,392,512,416,96,453,367,86,380,176,204,LUZERN,136645,91200,45445,15196,11857,3339,53596,43351,10245,66779,35314,31465
4,1004 FLUEHLI,664,476,188,252,217,35,159,132,27,252,127,125,LUZERN,136645,91200,45445,15196,11857,3339,53596,43351,10245,66779,35314,31465
5,1005 HASLE (LU),674,499,175,208,168,40,245,222,23,219,108,111,LUZERN,136645,91200,45445,15196,11857,3339,53596,43351,10245,66779,35314,31465
6,1006 MARBACH (LU),579,392,187,318,220,98,133,115,18,128,57,71,LUZERN,136645,91200,45445,15196,11857,3339,53596,43351,10245,66779,35314,31465
7,1007 ROMOOS,348,278,70,195,163,32,84,74,10,67,41,26,LUZERN,136645,91200,45445,15196,11857,3339,53596,43351,10245,66779,35314,31465
8,1008 SCHUEPFHEIM,1402,980,422,403,339,64,414,362,52,580,276,304,LUZERN,136645,91200,45445,15196,11857,3339,53596,43351,10245,66779,35314,31465
9,1009 WERTHENSTEIN,842,596,246,201,146,55,340,281,59,298,167,131,LUZERN,136645,91200,45445,15196,11857,3339,53596,43351,10245,66779,35314,31465
10,HOCHDORF,22065,15066,6999,2440,1850,590,10233,8246,1987,9330,4944,4386,LUZERN,136645,91200,45445,15196,11857,3339,53596,43351,10245,66779,35314,31465
11,1021 AESCH (LU),319,241,78,82,64,18,148,117,31,87,60,27,LUZERN,136645,91200,45445,15196,11857,3339,53596,43351,10245,66779,35314,31465
12,1022 ALTWIS,150,106,44,55,39,16,51,41,10,44,26,18,LUZERN,136645,91200,45445,15196,11857,3339,53596,43351,10245,66779,35314,31465
13,1023 BALLWIL,674,485,189,129,112,17,282,231,51,263,142,121,LUZERN,136645,91200,45445,15196,11857,3339,53596,43351,10245,66779,35314,31465
14,1024 EMMEN,10784,7357,3427,216,169,47,5754,4639,1115,4777,2533,2244,LUZERN,136645,91200,45445,15196,11857,3339,53596,43351,10245,66779,35314,31465
15,1025 ERMENSEE,224,160,64,50,39,11,92,80,12,82,41,41,LUZERN,136645,91200,45445,15196,11857,3339,53596,43351,10245,66779,35314,31465
16,1026 ESCHENBACH (LU),1045,719,326,154,126,28,454,359,95,435,232,203,LUZERN,136645,91200,45445,15196,11857,3339,53596,43351,10245,66779,35314,31465
17,1027 GELFINGEN,194,140,54,45,35,10,72,57,15,77,48,29,LUZERN,136645,91200,45445,15196,11857,3339,53596,43351,10245,66779,35314,31465
18,1028 HAEMIKON,121,95,26,43,39,4,40,36,4,37,20,17,LUZERN,136645,91200,45445,15196,11857,3339,53596,43351,10245,66779,35314,31465
19,1029 HERLISBERG,87,65,22,32,27,5,24,22,2,31,16,15,LUZERN,136645,91200,45445,15196,11857,3339,53596,43351,10245,66779,35314,31465
20,1030 HITZKIRCH,689,470,219,57,38,19,348,269,79,283,163,120,LUZERN,136645,91200,45445,15196,11857,3339,53596,43351,10245,66779,35314,31465
21,1031 HOCHDORF,2664,1673,991,116,94,22,1255,964,291,1286,612,674,LUZERN,136645,91200,45445,15196,11857,3339,53596,43351,10245,66779,35314,31465
22,1032 HOHENRAIN,788,516,272,309,242,67,184,153,31,293,121,172,LUZERN,136645,91200,45445,15196,11857,3339,53596,43351,10245,66779,35314,31465
23,1033 INWIL,604,440,164,157,122,35,245,205,40,201,112,89,LUZERN,136645,91200,45445,15196,11857,3339,53596,43351,10245,66779,35314,31465
24,1034 LIELI,65,45,20,27,20,7,16,16,-,21,9,12,LUZERN,136645,91200,45445,15196,11857,3339,53596,43351,10245,66779,35314,31465
25,1035 MOSFN,82,51,31,18,12,6,36,23,13,28,16,12,LUZERN,136645,91200,45445,15196,11857,3339,53596,43351,10245,66779,35314,31465
26,1036 MUESWANGEN,98,75,23,44,38,6,32,28,4,22,9,13,LUZERN,136645,91200,45445,15196,11857,3339,53596,43351,10245,66779,35314,31465
27,1037 RAIN,530,385,145,164,120,44,174,145,29,191,119,72,LUZERN,136645,91200,45445,15196,11857,3339,53596,43351,10245,66779,35314,31465
28,1038 RETSCHWIL,75,52,23,45,31,14,17,13,4,13,8,5,LUZERN,136645,91200,45445,15196,11857,3339,53596,43351,10245,66779,35314,31465
29,1039 ROEMERSWIL,504,343,161,259,167,92,114,99,15,129,76,53,LUZERN,136645,91200,45445,15196,11857,3339,53596,43351,10245,66779,35314,31465
30,1040 ROTHENBURG,1954,1368,586,215,169,46,775,652,123,961,545,416,LUZERN,136645,91200,45445,15196,11857,3339,53596,43351,10245,66779,35314,31465
31,1041 SCHONGAU,342,228,114,177,116,61,105,82,23,58,30,28,LUZERN,136645,91200,45445,15196,11857,3339,53596,43351,10245,66779,35314,31465
32,1042 SULZ (LU),72,52,20,46,31,15,15,15,-,11,6,5,LUZERN,136645,91200,45445,15196,11857,3339,53596,43351,10245,66779,35314,31465
33,LUZERN,68342,43791,24551,2205,1737,468,24430,19763,4667,40889,21756,19133,LUZERN,136645,91200,45445,15196,11857,3339,53596,43351,10245,66779,35314,31465
34,1051 ADLIGENSWIL,869,642,227,87,77,10,274,238,36,503,324,179,LUZERN,136645,91200,45445,15196,11857,3339,53596,43351,10245,66779,35314,31465
35,1052 BUCHRAIN,1424,978,446,36,29,7,827,668,159,559,279,280,LUZERN,136645,91200,45445,15196,11857,3339,53596,43351,10245,66779,35314,31465
36,1053 DIERIKON,369,251,118,28,21,7,162,126,36,179,104,75,LUZERN,136645,91200,45445,15196,11857,3339,53596,43351,10245,66779,35314,31465
37,1054 EBIKON,4122,2797,1325,119,92,27,1786,1450,336,2193,1239,954,LUZERN,136645,91200,45445,15196,11857,3339,53596,43351,10245,66779,35314,31465
38,1055 GISIKON,178,118,60,28,19,9,64,53,11,86,46,40,LUZERN,136645,91200,45445,15196,11857,3339,53596,43351,10245,66779,35314,31465
39,1056 GREPPEN,176,119,57,44,29,15,64,58,6,68,32,36,LUZERN,136645,91200,45445,15196,11857,3339,53596,43351,10245,66779,35314,31465
40,1057 HONAU,60,36,24,25,13,12,22,18,4,13,5,8,LUZERN,136645,91200,45445,15196,11857,3339,53596,43351,10245,66779,35314,31465
41,1058 HORW,5411,3621,1790,160,120,40,1878,1570,308,3334,1906,1428,LUZERN,136645,91200,45445,15196,11857,3339,53596,43351,10245,66779,35314,31465
42,1059 KRIENS,9564,6491,3073,212,166,46,3745,3073,672,5566,3227,2339,LUZERN,136645,91200,45445,15196,11857,3339,53596,43351,10245,66779,35314,31465
43,1060 LITTAU,7229,4801,2428,131,110,21,3514,2840,674,3548,1830,1718,LUZERN,136645,91200,45445,15196,11857,3339,53596,43351,10245,66779,35314,31465
44,1061 LUZERN,30678,18178,12500,186,165,21,9121,7165,1956,20751,10441,10310,LUZERN,136645,91200,45445,15196,11857,3339,53596,43351,10245,66779,35314,31465
45,1062 MALTERS,2136,1517,619,424,313,111,919,759,160,770,429,341,LUZERN,136645,91200,45445,15196,11857,3339,53596,43351,10245,66779,35314,31465
46,1063 MEGGEN,2143,1473,670,112,98,14,559,483,76,1459,882,577,LUZERN,136645,91200,45445,15196,11857,3339,53596,43351,10245,66779,35314,31465
47,1064 MEIERSKAPPEL,327,245,82,71,66,5,108,98,10,145,80,65,LUZERN,136645,91200,45445,15196,11857,3339,53596,43351,10245,66779,35314,31465
48,1065 ROOT,1242,898,344,92,75,17,648,541,107,498,279,219,LUZERN,136645,91200,45445,15196,11857,3339,53596,43351,10245,66779,35314,31465
49,1066 SCHWARZENBERG,480,330,150,190,131,59,151,133,18,139,66,73,LUZERN,136645,91200,45445,15196,11857,3339,53596,43351,10245,66779,35314,31465
50,1067 UDLIGENSWIL,515,368,147,84,70,14,174,146,28,252,149,103,LUZERN,136645,91200,45445,15196,11857,3339,53596,43351,10245,66779,35314,31465
51,1068 VITZNAU,417,279,138,56,42,14,130,105,25,230,131,99,LUZERN,136645,91200,45445,15196,11857,3339,53596,43351,10245,66779,35314,31465
52,1069 WEGGIS,1002,649,353,120,101,19,284,239,45,596,307,289,LUZERN,136645,91200,45445,15196,11857,3339,53596,43351,10245,66779,35314,31465
53,SURSEE,21189,14606,6583,3963,3147,816,8695,6971,1724,8432,4421,4011,LUZERN,136645,91200,45445,15196,11857,3339,53596,43351,10245,66779,35314,31465
54,1081 BEROMUENSTER,742,492,250,53,43,10,340,267,73,346,180,166,LUZERN,136645,91200,45445,15196,11857,3339,53596,43351,10245,66779,35314,31465
55,1082 BUERON,707,479,228,82,63,19,409,307,102,211,105,106,LUZERN,136645,91200,45445,15196,11857,3339,53596,43351,10245,66779,35314,31465
56,1083 BUTTISHOLZ,861,656,205,253,215,38,339,286,53,267,155,112,LUZERN,136645,91200,45445,15196,11857,3339,53596,43351,10245,66779,35314,31465
57,1084 EICH,348,251,97,90,72,18,90,79,11,167,99,68,LUZERN,136645,91200,45445,15196,11857,3339,53596,43351,10245,66779,35314,31465
