,mun_name,mun_employed,male_employed,fem_employed,mun_1sector,male_1sector,fem_1sector,mun_2sector,male_2sector,fem_2sector,mun_3sector,male_3sector,fem_3sector,can_name,1,2,3,4,5,6,7,8,9,10,11,12
0,OBERKLETTGAU,1480,1013,467,322,204,118,607,499,108,539,302,237,SCHAFFHAUSEN,33849,21622,12227,2124,1361,763,17073,12862,4211,14438,7280,7158
1,2901 GAECHLINGEN,313,200,113,94,53,41,103,86,17,112,58,54,SCHAFFHAUSEN,33849,21622,12227,2124,1361,763,17073,12862,4211,14438,7280,7158
2,2902 GUNTMADINGEN,96,63,33,39,27,12,25,18,7,31,18,13,SCHAFFHAUSEN,33849,21622,12227,2124,1361,763,17073,12862,4211,14438,7280,7158
3,2903 LOEHNINGEN,329,238,91,51,38,13,145,125,20,130,72,58,SCHAFFHAUSEN,33849,21622,12227,2124,1361,763,17073,12862,4211,14438,7280,7158
4,2904 NEUNKIRCH,602,435,167,68,51,17,304,248,56,228,135,93,SCHAFFHAUSEN,33849,21622,12227,2124,1361,763,17073,12862,4211,14438,7280,7158
5,2905 OSTERFINGEN,140,77,63,70,35,35,30,22,8,38,19,19,SCHAFFHAUSEN,33849,21622,12227,2124,1361,763,17073,12862,4211,14438,7280,7158
6,REIAT,2947,1958,989,326,209,117,1530,1125,405,1084,619,465,SCHAFFHAUSEN,33849,21622,12227,2124,1361,763,17073,12862,4211,14438,7280,7158
7,2911 ALTDORF (SH),73,50,23,32,17,15,23,19,4,16,12,4,SCHAFFHAUSEN,33849,21622,12227,2124,1361,763,17073,12862,4211,14438,7280,7158
8,2912 BARZHEIM,83,46,37,34,19,15,25,17,8,24,10,14,SCHAFFHAUSEN,33849,21622,12227,2124,1361,763,17073,12862,4211,14438,7280,7158
9,2913 BIBERN (SH),114,85,29,18,12,6,48,38,10,48,35,13,SCHAFFHAUSEN,33849,21622,12227,2124,1361,763,17073,12862,4211,14438,7280,7158
10,2914 BUETTENHARDT,77,57,20,19,13,6,33,28,5,25,16,9,SCHAFFHAUSEN,33849,21622,12227,2124,1361,763,17073,12862,4211,14438,7280,7158
11,2915 DOERFLINGEN,248,160,88,63,40,23,77,60,17,107,59,48,SCHAFFHAUSEN,33849,21622,12227,2124,1361,763,17073,12862,4211,14438,7280,7158
12,2916 HOFEN,53,35,18,5,4,1,25,19,6,23,12,11,SCHAFFHAUSEN,33849,21622,12227,2124,1361,763,17073,12862,4211,14438,7280,7158
13,2917 LOHN (SH),172,122,50,23,16,7,89,70,19,59,35,24,SCHAFFHAUSEN,33849,21622,12227,2124,1361,763,17073,12862,4211,14438,7280,7158
14,2918 OPFERTSHOFEN (SH),55,35,20,21,13,8,16,11,5,17,11,6,SCHAFFHAUSEN,33849,21622,12227,2124,1361,763,17073,12862,4211,14438,7280,7158
15,2919 STETTEN (5H),188,136,52,29,18,11,73,63,10,86,55,31,SCHAFFHAUSEN,33849,21622,12227,2124,1361,763,17073,12862,4211,14438,7280,7158
16,2920 THAYNGEN,1884,1232,652,82,57,25,1121,800,321,679,374,305,SCHAFFHAUSEN,33849,21622,12227,2124,1361,763,17073,12862,4211,14438,7280,7158
17,SCHAFFHAUSEN,24392,15410,8982,494,354,140,12929,9645,3284,10814,5322,5492,SCHAFFHAUSEN,33849,21622,12227,2124,1361,763,17073,12862,4211,14438,7280,7158
18,2931 BARGEN (SH),122,82,40,28,19,9,27,21,6,67,42,25,SCHAFFHAUSEN,33849,21622,12227,2124,1361,763,17073,12862,4211,14438,7280,7158
19,2932 BERINGEN,1119,766,353,57,39,18,642,515,127,418,212,206,SCHAFFHAUSEN,33849,21622,12227,2124,1361,763,17073,12862,4211,14438,7280,7158
20,2933 BUCHBERG,280,193,87,53,34,19,104,89,15,123,70,53,SCHAFFHAUSEN,33849,21622,12227,2124,1361,763,17073,12862,4211,14438,7280,7158
21,2934 HEMMENTAL,214,153,61,29,22,7,94,80,14,91,51,40,SCHAFFHAUSEN,33849,21622,12227,2124,1361,763,17073,12862,4211,14438,7280,7158
22,2936 MERISHAUSEN,260,189,71,45,35,10,118,95,23,96,59,37,SCHAFFHAUSEN,33849,21622,12227,2124,1361,763,17073,12862,4211,14438,7280,7158
23,2937 NEUHAUSEN AM RH'FALL,5337,3415,1922,42,35,7,3293,2430,863,1984,939,1045,SCHAFFHAUSEN,33849,21622,12227,2124,1361,763,17073,12862,4211,14438,7280,7158
24,2938 RUEDLINGEN,232,150,82,45,23,22,71,64,7,116,63,53,SCHAFFHAUSEN,33849,21622,12227,2124,1361,763,17073,12862,4211,14438,7280,7158
25,2939 SCHAFFHAUSEN,16828,10462,6366,195,147,48,8580,6351,2229,7919,3886,4033,SCHAFFHAUSEN,33849,21622,12227,2124,1361,763,17073,12862,4211,14438,7280,7158
26,SCHLEITHEIM,1237,818,419,252,173,79,494,402,92,478,236,242,SCHAFFHAUSEN,33849,21622,12227,2124,1361,763,17073,12862,4211,14438,7280,7158
27,2951 BEGGINGEN,217,143,74,83,55,28,62,53,9,68,33,35,SCHAFFHAUSEN,33849,21622,12227,2124,1361,763,17073,12862,4211,14438,7280,7158
28,2952 SCHLEITHEIM,714,466,248,104,79,25,318,251,67,286,132,154,SCHAFFHAUSEN,33849,21622,12227,2124,1361,763,17073,12862,4211,14438,7280,7158
29,2953 SIBLINGEN,306,209,97,65,39,26,114,98,16,124,71,53,SCHAFFHAUSEN,33849,21622,12227,2124,1361,763,17073,12862,4211,14438,7280,7158
30,STEIN,1978,1256,722,222,142,80,807,618,189,929,489,440,SCHAFFHAUSEN,33849,21622,12227,2124,1361,763,17073,12862,4211,14438,7280,7158
31,2961 BUCH (SH),114,80,34,35,23,12,30,26,4,49,31,18,SCHAFFHAUSEN,33849,21622,12227,2124,1361,763,17073,12862,4211,14438,7280,7158
32,2962 HEMISHOFEN,132,91,41,39,26,13,31,25,6,60,39,21,SCHAFFHAUSEN,33849,21622,12227,2124,1361,763,17073,12862,4211,14438,7280,7158
33,2963 RAMSEN,508,323,185,99,62,37,172,137,35,228,122,106,SCHAFFHAUSEN,33849,21622,12227,2124,1361,763,17073,12862,4211,14438,7280,7158
34,2964 STEIN AM RHEIN,1224,762,462,49,31,18,574,430,144,592,297,295,SCHAFFHAUSEN,33849,21622,12227,2124,1361,763,17073,12862,4211,14438,7280,7158
35,UNTERKLETTGAU,1815,1167,648,508,279,229,706,573,133,594,312,282,SCHAFFHAUSEN,33849,21622,12227,2124,1361,763,17073,12862,4211,14438,7280,7158
36,2971 HALLAU,903,582,321,200,109,91,387,306,81,313,166,147,SCHAFFHAUSEN,33849,21622,12227,2124,1361,763,17073,12862,4211,14438,7280,7158
37,2972 OBERHALLAU,178,112,66,85,45,40,53,46,7,40,21,19,SCHAFFHAUSEN,33849,21622,12227,2124,1361,763,17073,12862,4211,14438,7280,7158
38,2973 TRASADINGEN,237,144,93,71,38,33,81,62,19,85,44,41,SCHAFFHAUSEN,33849,21622,12227,2124,1361,763,17073,12862,4211,14438,7280,7158
39,2974 WILCHINGEN,497,329,168,152,87,65,185,159,26,156,81,75,SCHAFFHAUSEN,33849,21622,12227,2124,1361,763,17073,12862,4211,14438,7280,7158
