,mun_name,mun_employed,male_employed,fem_employed,mun_1sector,male_1sector,fem_1sector,mun_2sector,male_2sector,fem_2sector,mun_3sector,male_3sector,fem_3sector,can_name,can_employed,can_male_employed,can_fem_employed,can_mun_1sector,can_male_1sector,can_fem_1sector,can_mun_2sector,can_male_2sector,can_fem_2sector,can_mun_3sector,can_male_3sector,can_fem_3sector,can_1sector_perc,district
2,4401 ARBON,5320,3497,1823,47,40,7,3558,2673,885,1698,771,927,THURGAU,Unnamed: 1,88155,57087,31068,9823,6858,2965,43322,32370,10952,34701,17688,17013,1
3,4402 FRASNACHT,448,318,130,48,41,7,261,199,62,138,77,61,THURGAU,Unnamed: 1,88155,57087,31068,9823,6858,2965,43322,32370,10952,34701,17688,17013,1
4,4406 DOZWIL,176,114,62,24,17,7,70,53,17,81,43,38,THURGAU,Unnamed: 1,88155,57087,31068,9823,6858,2965,43322,32370,10952,34701,17688,17013,1
5,4411 EGNACH,1583,1067,516,381,278,103,679,514,165,519,272,247,THURGAU,Unnamed: 1,88155,57087,31068,9823,6858,2965,43322,32370,10952,34701,17688,17013,1
6,4416 HEFENHOFEN,336,234,102,82,53,29,174,136,38,79,44,35,THURGAU,Unnamed: 1,88155,57087,31068,9823,6858,2965,43322,32370,10952,34701,17688,17013,1
7,4421 HORN,962,616,346,28,22,6,562,414,148,369,178,191,THURGAU,Unnamed: 1,88155,57087,31068,9823,6858,2965,43322,32370,10952,34701,17688,17013,1
8,4426 KESSWIL,285,196,89,68,53,15,120,88,32,96,55,41,THURGAU,Unnamed: 1,88155,57087,31068,9823,6858,2965,43322,32370,10952,34701,17688,17013,1
9,4431 ROGGWIL (TO),709,497,212,143,115,28,296,236,60,268,144,124,THURGAU,Unnamed: 1,88155,57087,31068,9823,6858,2965,43322,32370,10952,34701,17688,17013,1
10,4436 ROMANSHORN,3682,2400,1282,125,86,39,1795,1289,506,1752,1020,732,THURGAU,Unnamed: 1,88155,57087,31068,9823,6858,2965,43322,32370,10952,34701,17688,17013,1
11,4441 SALMSACH,552,355,197,53,32,21,307,210,97,189,111,78,THURGAU,Unnamed: 1,88155,57087,31068,9823,6858,2965,43322,32370,10952,34701,17688,17013,1
12,4446 SOMMERI,257,132,125,69,43,26,70,61,9,118,28,90,THURGAU,Unnamed: 1,88155,57087,31068,9823,6858,2965,43322,32370,10952,34701,17688,17013,1
13,4451 UTTWIL,413,270,143,77,50,27,186,133,53,148,86,62,THURGAU,Unnamed: 1,88155,57087,31068,9823,6858,2965,43322,32370,10952,34701,17688,17013,1
15,4461 AMRISWIL,4310,2705,1605,244,166,78,2506,1711,795,1551,824,727,THURGAU,Unnamed: 1,88155,57087,31068,9823,6858,2965,43322,32370,10952,34701,17688,17013,1
16,4471 BISCHOFSZELL,1888,1223,665,50,36,14,1148,839,309,686,346,340,THURGAU,Unnamed: 1,88155,57087,31068,9823,6858,2965,43322,32370,10952,34701,17688,17013,1
18,4476 BUCHACKERN,73,50,23,28,14,14,31,26,5,13,10,3,THURGAU,Unnamed: 1,88155,57087,31068,9823,6858,2965,43322,32370,10952,34701,17688,17013,1
19,4477 ENGISHOFEN,93,60,33,44,28,16,27,19,8,22,13,9,THURGAU,Unnamed: 1,88155,57087,31068,9823,6858,2965,43322,32370,10952,34701,17688,17013,1
20,4478 ENNETAACH,247,157,90,18,10,8,193,128,65,36,19,17,THURGAU,Unnamed: 1,88155,57087,31068,9823,6858,2965,43322,32370,10952,34701,17688,17013,1
21,4479 ERLEN,471,291,180,28,20,8,273,200,73,167,70,97,THURGAU,Unnamed: 1,88155,57087,31068,9823,6858,2965,43322,32370,10952,34701,17688,17013,1
22,4480 KUEMMERTSHAUSEN,89,62,27,32,23,9,35,30,5,22,9,13,THURGAU,Unnamed: 1,88155,57087,31068,9823,6858,2965,43322,32370,10952,34701,17688,17013,1
24,4486 GOTTSHAUS,343,226,117,153,105,48,100,81,19,90,40,50,THURGAU,Unnamed: 1,88155,57087,31068,9823,6858,2965,43322,32370,10952,34701,17688,17013,1
25,4487 HAUPTWIL,364,233,131,39,29,10,214,153,61,111,51,60,THURGAU,Unnamed: 1,88155,57087,31068,9823,6858,2965,43322,32370,10952,34701,17688,17013,1
27,4491 HELDSWIL,138,91,47,83,54,29,35,30,5,20,7,13,THURGAU,Unnamed: 1,88155,57087,31068,9823,6858,2965,43322,32370,10952,34701,17688,17013,1
28,4492 HOHENTANNEN,127,79,48,72,41,31,28,24,4,26,13,13,THURGAU,Unnamed: 1,88155,57087,31068,9823,6858,2965,43322,32370,10952,34701,17688,17013,1
30,4496 BUHWIL,93,62,31,42,27,15,32,25,7,18,10,8,THURGAU,Unnamed: 1,88155,57087,31068,9823,6858,2965,43322,32370,10952,34701,17688,17013,1
31,4497 HALDEN,78,55,23,5,3,2,45,38,7,28,14,14,THURGAU,Unnamed: 1,88155,57087,31068,9823,6858,2965,43322,32370,10952,34701,17688,17013,1
32,4498 NEUKIRCH A.D.THUR,145,90,55,72,46,26,27,24,3,46,20,26,THURGAU,Unnamed: 1,88155,57087,31068,9823,6858,2965,43322,32370,10952,34701,17688,17013,1
33,4499 SCHOENENBERG (TG),351,223,128,13,8,5,220,148,72,118,67,51,THURGAU,Unnamed: 1,88155,57087,31068,9823,6858,2965,43322,32370,10952,34701,17688,17013,1
34,4500 SCHWEIZERSHOLZ,138,104,34,67,50,17,48,43,5,23,11,12,THURGAU,Unnamed: 1,88155,57087,31068,9823,6858,2965,43322,32370,10952,34701,17688,17013,1
36,4507 GOETIGHOFEN,66,45,21,29,21,8,15,12,3,22,12,10,THURGAU,Unnamed: 1,88155,57087,31068,9823,6858,2965,43322,32370,10952,34701,17688,17013,1
37,4508 KRADOLF,524,353,171,33,24,9,317,236,81,168,88,80,THURGAU,Unnamed: 1,88155,57087,31068,9823,6858,2965,43322,32370,10952,34701,17688,17013,1
38,4509 RIEDT,226,153,73,29,21,8,136,101,35,61,31,30,THURGAU,Unnamed: 1,88155,57087,31068,9823,6858,2965,43322,32370,10952,34701,17688,17013,1
39,4510 SUL GEN,891,601,290,45,35,10,537,414,123,307,151,156,THURGAU,Unnamed: 1,88155,57087,31068,9823,6858,2965,43322,32370,10952,34701,17688,17013,1
41,4516 SCHOCHERSWIL,98,70,28,25,18,7,41,35,6,31,16,15,THURGAU,Unnamed: 1,88155,57087,31068,9823,6858,2965,43322,32370,10952,34701,17688,17013,1
42,4517 SITTERDORF,413,275,138,110,75,35,200,152,48,103,48,55,THURGAU,Unnamed: 1,88155,57087,31068,9823,6858,2965,43322,32370,10952,34701,17688,17013,1
43,4518 ZIHLSCHLACHT,244,163,81,54,40,14,88,75,13,102,48,54,THURGAU,Unnamed: 1,88155,57087,31068,9823,6858,2965,43322,32370,10952,34701,17688,17013,1
46,4531 BASADINGEN,321,219,102,64,41,23,140,118,22,115,58,57,THURGAU,Unnamed: 1,88155,57087,31068,9823,6858,2965,43322,32370,10952,34701,17688,17013,1
47,4532 METT-OBERSCHLATT,100,67,33,33,19,14,37,30,7,30,18,12,THURGAU,Unnamed: 1,88155,57087,31068,9823,6858,2965,43322,32370,10952,34701,17688,17013,1
48,4533 SCHLATTINGEN,206,137,69,64,44,20,77,65,12,64,28,36,THURGAU,Unnamed: 1,88155,57087,31068,9823,6858,2965,43322,32370,10952,34701,17688,17013,1
49,4534 UNTERSCHLATT,341,229,112,73,54,19,154,117,37,113,58,55,THURGAU,Unnamed: 1,88155,57087,31068,9823,6858,2965,43322,32370,10952,34701,17688,17013,1
51,4541 DIESSENHOFEN,1249,800,449,30,22,8,671,513,158,543,263,280,THURGAU,Unnamed: 1,88155,57087,31068,9823,6858,2965,43322,32370,10952,34701,17688,17013,1
52,4542 WILLISDORF,76,49,27,18,13,5,17,16,1,40,19,21,THURGAU,Unnamed: 1,88155,57087,31068,9823,6858,2965,43322,32370,10952,34701,17688,17013,1
