,mun_name,mun_pop,male_pop,fem_pop,swiss_pop,swiss_male,swiss_fem,foreign_pop,foreign_male,foreign_fem,swiss_promille,foreign_promille,can_name,can_population,can_male_pop,can_fem_pop,can_swiss_pop,can_swiss_male,can_swiss_fem,can_foreign_pop,can_foreign_male,can_foreign_fem,can_swiss_promille,can_foreign_promille,district
1,1 AEUGST AM ALBIS,866,445,421,832,422,410,34,23,11,961,39,ZUERICH,1122839,546198,576641,938650,442059,496591,184189,104139,80050,836,164,1
2,2 AFFOLTERN AM ALBIS,8064,4012,4052,6637,3192,3445,1427,820,607,823,177,ZUERICH,1122839,546198,576641,938650,442059,496591,184189,104139,80050,836,164,1
3,3 BONSTETTEN,2123,1085,1038,1952,990,962,171,95,76,919,81,ZUERICH,1122839,546198,576641,938650,442059,496591,184189,104139,80050,836,164,1
4,4 HAUSEN AM ALBIS,2216,1160,1056,2001,1038,963,215,122,93,903,97,ZUERICH,1122839,546198,576641,938650,442059,496591,184189,104139,80050,836,164,1
5,5 HEDINGEN,1915,968,947,1623,786,837,292,182,110,848,152,ZUERICH,1122839,546198,576641,938650,442059,496591,184189,104139,80050,836,164,1
6,6 KAPPEL AM ALOIS,567,291,276,549,281,268,18,10,8,968,32,ZUERICH,1122839,546198,576641,938650,442059,496591,184189,104139,80050,836,164,1
7,7 KNONAU,951,508,443,882,457,425,69,51,18,927,73,ZUERICH,1122839,546198,576641,938650,442059,496591,184189,104139,80050,836,164,1
8,8 MASCHWANDEN,426,217,209,420,213,207,6,4,2,986,14,ZUERICH,1122839,546198,576641,938650,442059,496591,184189,104139,80050,836,164,1
9,9 METTMENSTETTEN,2297,1189,1108,2086,1066,1020,211,123,88,908,92,ZUERICH,1122839,546198,576641,938650,442059,496591,184189,104139,80050,836,164,1
10,10 OBFEL.DEN,3315,1689,1626,2876,1431,1445,439,258,181,868,132,ZUERICH,1122839,546198,576641,938650,442059,496591,184189,104139,80050,836,164,1
11,11 OTTENBACH,1389,700,689,1285,639,646,104,61,43,925,75,ZUERICH,1122839,546198,576641,938650,442059,496591,184189,104139,80050,836,164,1
12,12 RIFFERSWIL,543,276,267,528,269,259,15,7,8,972,28,ZUERICH,1122839,546198,576641,938650,442059,496591,184189,104139,80050,836,164,1
13,13 STALLIKON,1475,767,708,1325,657,668,150,110,40,898,102,ZUERICH,1122839,546198,576641,938650,442059,496591,184189,104139,80050,836,164,1
14,14 WETTSWIL AM ALOIS,3366,1677,1689,3016,1474,1542,350,203,147,896,104,ZUERICH,1122839,546198,576641,938650,442059,496591,184189,104139,80050,836,164,1
16,21 ADLIKON,424,216,208,408,208,200,16,8,8,962,38,ZUERICH,1122839,546198,576641,938650,442059,496591,184189,104139,80050,836,164,1
17,22 BENKEN (ZH),483,259,224,476,254,222,7,5,2,986,14,ZUERICH,1122839,546198,576641,938650,442059,496591,184189,104139,80050,836,164,1
18,23 BERG AM IRCHEL,376,184,192,366,177,189,10,7,3,973,27,ZUERICH,1122839,546198,576641,938650,442059,496591,184189,104139,80050,836,164,1
19,24 BUCH AM IRCHEL,437,223,214,434,221,213,3,2,1,993,7,ZUERICH,1122839,546198,576641,938650,442059,496591,184189,104139,80050,836,164,1
20,25 DACHSEN,1098,557,541,1022,511,511,76,46,30,931,69,ZUERICH,1122839,546198,576641,938650,442059,496591,184189,104139,80050,836,164,1
21,26 DORF,319,155,164,307,146,161,12,9,3,962,38,ZUERICH,1122839,546198,576641,938650,442059,496591,184189,104139,80050,836,164,1
22,27 FEUERTHALEN,2920,1419,1501,2465,1151,1314,455,268,187,844,156,ZUERICH,1122839,546198,576641,938650,442059,496591,184189,104139,80050,836,164,1
23,78 Pl_AACH,871,424,447,831,394,417,40,30,TO,954,4F,ZUERICH,1122839,546198,576641,938650,442059,496591,184189,104139,80050,836,164,1
24,29 FLURLINGEN,1020,521,499,842,423,419,178,98,80,825,175,ZUERICH,1122839,546198,576641,938650,442059,496591,184189,104139,80050,836,164,1
25,30 ANDELFINGEN,1658,834,824,1469,712,757,189,122,67,886,114,ZUERICH,1122839,546198,576641,938650,442059,496591,184189,104139,80050,836,164,1
26,31 HENGGART,970,476,494,941,457,484,29,19,10,970,30,ZUERICH,1122839,546198,576641,938650,442059,496591,184189,104139,80050,836,164,1
27,32 HUMLIKON,317,163,154,307,157,150,10,6,4,968,32,ZUERICH,1122839,546198,576641,938650,442059,496591,184189,104139,80050,836,164,1
28,33 KLEINANDELFINGEN,1284,656,628,1173,581,592,111,75,36,914,86,ZUERICH,1122839,546198,576641,938650,442059,496591,184189,104139,80050,836,164,1
29,34 LAUFEN—UHWIESEN,1170,588,582,1118,552,566,52,36,16,956,44,ZUERICH,1122839,546198,576641,938650,442059,496591,184189,104139,80050,836,164,1
30,35 MARTHALEN,1259,643,616,1222,611,611,37,32,5,971,29,ZUERICH,1122839,546198,576641,938650,442059,496591,184189,104139,80050,836,164,1
31,36 OBERSTAMMHEIM,851,431,420,814,407,407,37,24,13,957,43,ZUERICH,1122839,546198,576641,938650,442059,496591,184189,104139,80050,836,164,1
32,37 OSSINGEN,953,490,463,897,452,445,56,38,18,941,59,ZUERICH,1122839,546198,576641,938650,442059,496591,184189,104139,80050,836,164,1
33,38 RHEINAU,1897,931,966,1694,821,873,203,110,93,893,107,ZUERICH,1122839,546198,576641,938650,442059,496591,184189,104139,80050,836,164,1
34,39 THALHEIM AN DER THUR,470,252,218,465,249,216,5,3,2,989,11,ZUERICH,1122839,546198,576641,938650,442059,496591,184189,104139,80050,836,164,1
35,40 TRUELLIKON,860,429,431,823,406,417,37,23,14,957,43,ZUERICH,1122839,546198,576641,938650,442059,496591,184189,104139,80050,836,164,1
36,41 TRUTTIKON,319,173,146,310,166,144,9,7,2,972,28,ZUERICH,1122839,546198,576641,938650,442059,496591,184189,104139,80050,836,164,1
37,42 UNTERSTAMMHEIM,685,343,342,657,325,332,28,18,10,959,41,ZUERICH,1122839,546198,576641,938650,442059,496591,184189,104139,80050,836,164,1
38,43 VOLKEN,205,114,91,198,110,88,7,4,3,966,34,ZUERICH,1122839,546198,576641,938650,442059,496591,184189,104139,80050,836,164,1
39,44 WALTALINGEN,458,241,217,436,226,210,22,15,7,952,48,ZUERICH,1122839,546198,576641,938650,442059,496591,184189,104139,80050,836,164,1
41,51 BACHENBUELACH,2859,1478,1381,2133,1075,1058,726,403,323,746,254,ZUERICH,1122839,546198,576641,938650,442059,496591,184189,104139,80050,836,164,1
42,52 BASSERSDORF,5335,2738,2597,4455,2188,2267,880,550,330,835,165,ZUERICH,1122839,546198,576641,938650,442059,496591,184189,104139,80050,836,164,1
43,53 BUELACH,12292,6240,6052,10094,4968,5126,2198,1272,926,821,179,ZUERICH,1122839,546198,576641,938650,442059,496591,184189,104139,80050,836,164,1
44,54 DIETLIKON,5310,2685,2625,4368,2144,2224,942,541,401,823,177,ZUERICH,1122839,546198,576641,938650,442059,496591,184189,104139,80050,836,164,1
45,55 EGLISAU,2462,1239,1223,2220,1085,1135,242,154,88,902,98,ZUERICH,1122839,546198,576641,938650,442059,496591,184189,104139,80050,836,164,1
46,56 EMBRACH,5893,2954,2939,4941,2399,2542,952,555,397,838,162,ZUERICH,1122839,546198,576641,938650,442059,496591,184189,104139,80050,836,164,1
47,57 FREIENSTEIN—TEUFEN,1485,763,722,1291,649,642,194,114,80,869,131,ZUERICH,1122839,546198,576641,938650,442059,496591,184189,104139,80050,836,164,1
48,58 GLATTFELDEN,2753,1418,1335,2100,1042,1058,653,376,277,763,237,ZUERICH,1122839,546198,576641,938650,442059,496591,184189,104139,80050,836,164,1
49,59 HOCHFELDEN,928,483,445,788,388,400,140,95,45,849,151,ZUERICH,1122839,546198,576641,938650,442059,496591,184189,104139,80050,836,164,1
50,60 HOERI,1759,940,819,1302,666,636,457,274,183,740,260,ZUERICH,1122839,546198,576641,938650,442059,496591,184189,104139,80050,836,164,1
51,61 HUENTWANGEN,645,330,315,615,309,306,30,21,9,953,47,ZUERICH,1122839,546198,576641,938650,442059,496591,184189,104139,80050,836,164,1
52,62 KLOTEN,15845,8084,7761,12790,6352,6438,3055,1732,1323,807,193,ZUERICH,1122839,546198,576641,938650,442059,496591,184189,104139,80050,836,164,1
53,63 LUFINGEN,723,365,358,649,320,329,74,45,29,898,102,ZUERICH,1122839,546198,576641,938650,442059,496591,184189,104139,80050,836,164,1
54,64 NUERENSDORF,3348,1737,1611,2977,1502,1475,371,235,136,889,111,ZUERICH,1122839,546198,576641,938650,442059,496591,184189,104139,80050,836,164,1
55,65 OBEREMBRACH,744,385,359,704,358,346,40,27,13,946,54,ZUERICH,1122839,546198,576641,938650,442059,496591,184189,104139,80050,836,164,1
56,66 OPFIKON,11444,5740,5704,8923,4236,4687,2521,1504,1017,780,220,ZUERICH,1122839,546198,576641,938650,442059,496591,184189,104139,80050,836,164,1
57,67 RAFZ,2325,1196,1129,2004,997,1007,321,199,122,862,138,ZUERICH,1122839,546198,576641,938650,442059,496591,184189,104139,80050,836,164,1
58,68 RORBAS,1315,686,629,1042,521,521,273,165,108,792,208,ZUERICH,1122839,546198,576641,938650,442059,496591,184189,104139,80050,836,164,1
0,70 WASTERKINGEN,320,166,154,312,160,152,8,6,2,975,25,ZUERICH,1122839,546198,576641,938650,442059,496591,184189,104139,80050,836,164,1
1,71 WIL (ZH),899,482,417,859,457,402,40,25,15,956,44,ZUERICH,1122839,546198,576641,938650,442059,496591,184189,104139,80050,836,164,1
2,72 WINKEL,2028,1060,968,1789,913,876,239,147,92,882,118,ZUERICH,1122839,546198,576641,938650,442059,496591,184189,104139,80050,836,164,1
4,81 BACHS,428,221,207,419,216,203,9,5,4,979,21,ZUERICH,1122839,546198,576641,938650,442059,496591,184189,104139,80050,836,164,1
5,82 BOPPELSEN,705,356,349,663,336,327,42,20,22,940,60,ZUERICH,1122839,546198,576641,938650,442059,496591,184189,104139,80050,836,164,1
6,83 BUCHS (ZH),1838,965,873,1636,839,797,202,126,76,890,110,ZUERICH,1122839,546198,576641,938650,442059,496591,184189,104139,80050,836,164,1
7,84 DAELLIKON,2426,1270,1156,2024,1028,996,402,242,160,834,166,ZUERICH,1122839,546198,576641,938650,442059,496591,184189,104139,80050,836,164,1
8,85 DAENIKON,985,532,453,864,457,407,121,75,46,877,123,ZUERICH,1122839,546198,576641,938650,442059,496591,184189,104139,80050,836,164,1
9,86 DIELSDORF,3767,1884,1883,3094,1489,1605,673,395,278,821,179,ZUERICH,1122839,546198,576641,938650,442059,496591,184189,104139,80050,836,164,1
10,87 HUETTIKON,356,183,173,325,162,163,31,21,10,913,87,ZUERICH,1122839,546198,576641,938650,442059,496591,184189,104139,80050,836,164,1
11,88 NEERACH,1165,606,559,1062,544,518,103,62,41,912,88,ZUERICH,1122839,546198,576641,938650,442059,496591,184189,104139,80050,836,164,1
12,89 NIEDERGLATT,2939,1458,1481,2461,1180,1281,478,278,200,837,163,ZUERICH,1122839,546198,576641,938650,442059,496591,184189,104139,80050,836,164,1
13,90 NIEDERHASLI,5057,2610,2447,4257,2123,2134,800,487,313,842,158,ZUERICH,1122839,546198,576641,938650,442059,496591,184189,104139,80050,836,164,1
14,91 NIEDERWENINGEN,1269,657,612,1068,543,525,201,114,87,842,158,ZUERICH,1122839,546198,576641,938650,442059,496591,184189,104139,80050,836,164,1
15,92 OBERGLATT,4097,2113,1984,3225,1584,1641,872,529,343,787,213,ZUERICH,1122839,546198,576641,938650,442059,496591,184189,104139,80050,836,164,1
16,93 OBERWENINGEN,693,357,336,599,301,298,94,56,38,864,136,ZUERICH,1122839,546198,576641,938650,442059,496591,184189,104139,80050,836,164,1
17,94 OTELFINGEN,1243,648,595,1115,579,536,128,69,59,897,103,ZUERICH,1122839,546198,576641,938650,442059,496591,184189,104139,80050,836,164,1
18,95 REGENSBERG,639,337,302,606,312,294,33,25,8,948,52,ZUERICH,1122839,546198,576641,938650,442059,496591,184189,104139,80050,836,164,1
19,96 REGENSDORF,12300,6383,5917,9562,4749,4813,2738,1634,1104,777,223,ZUERICH,1122839,546198,576641,938650,442059,496591,184189,104139,80050,836,164,1
20,97 RUEMLANG,5055,2587,2468,4280,2123,2157,775,464,311,847,153,ZUERICH,1122839,546198,576641,938650,442059,496591,184189,104139,80050,836,164,1
21,98 SCHLEINIKON,451,228,223,415,203,212,36,25,11,920,80,ZUERICH,1122839,546198,576641,938650,442059,496591,184189,104139,80050,836,164,1
22,99 SCHOEFFLISDORF,696,380,316,623,336,287,73,44,29,895,105,ZUERICH,1122839,546198,576641,938650,442059,496591,184189,104139,80050,836,164,1
23,100 STADEL,1299,695,604,1249,665,584,50,30,20,962,38,ZUERICH,1122839,546198,576641,938650,442059,496591,184189,104139,80050,836,164,1
24,101 STEINMAUR,2109,1066,1043,1880,939,941,229,127,102,891,109,ZUERICH,1122839,546198,576641,938650,442059,496591,184189,104139,80050,836,164,1
25,102 WEIACH,692,357,335,640,321,319,52,36,16,925,75,ZUERICH,1122839,546198,576641,938650,442059,496591,184189,104139,80050,836,164,1
27,111 BAERETSWIL,3145,1602,1543,2914,1458,1456,231,144,87,927,73,ZUERICH,1122839,546198,576641,938650,442059,496591,184189,104139,80050,836,164,1
28,112 BUBIKON,3601,1861,1740,3217,1627,1590,384,234,150,893,107,ZUERICH,1122839,546198,576641,938650,442059,496591,184189,104139,80050,836,164,1
29,113 DUERNTEN,4927,2481,2446,4270,2064,2206,657,417,240,867,133,ZUERICH,1122839,546198,576641,938650,442059,496591,184189,104139,80050,836,164,1
30,114 FISCHENTHAL,1605,815,790,1410,701,709,195,114,81,879,121,ZUERICH,1122839,546198,576641,938650,442059,496591,184189,104139,80050,836,164,1
31,115 GOSSAU (ZH),6205,3132,3073,5675,2814,2861,530,318,212,915,85,ZUERICH,1122839,546198,576641,938650,442059,496591,184189,104139,80050,836,164,1
32,116 GRUENINGEN,2185,1052,1133,1983,942,1041,202,110,92,908,92,ZUERICH,1122839,546198,576641,938650,442059,496591,184189,104139,80050,836,164,1
33,117 HINWIL,7554,3840,3714,6830,3394,3436,724,446,278,904,96,ZUERICH,1122839,546198,576641,938650,442059,496591,184189,104139,80050,836,164,1
34,118 RUETI (ZH),9331,4546,4785,7525,3506,4019,1806,1040,766,806,194,ZUERICH,1122839,546198,576641,938650,442059,496591,184189,104139,80050,836,164,1
35,119 SEEGRAEBEN,1121,616,505,930,506,424,191,110,81,830,170,ZUERICH,1122839,546198,576641,938650,442059,496591,184189,104139,80050,836,164,1
36,120 WALD (ZH),7447,3606,3841,5747,2712,3035,1700,894,806,772,228,ZUERICH,1122839,546198,576641,938650,442059,496591,184189,104139,80050,836,164,1
37,121 WETZIKON (ZH),15859,7834,8025,12854,6125,6729,3005,1709,1296,811,189,ZUERICH,1122839,546198,576641,938650,442059,496591,184189,104139,80050,836,164,1
39,131 ADLISWIL,16418,8097,8321,13789,6618,7171,2629,1479,1150,840,160,ZUERICH,1122839,546198,576641,938650,442059,496591,184189,104139,80050,836,164,1
40,132 HIRZEL,1355,704,651,1311,677,634,44,27,17,968,32,ZUERICH,1122839,546198,576641,938650,442059,496591,184189,104139,80050,836,164,1
41,133 HORGEN,16577,8137,8440,13470,6368,7102,3107,1769,1338,813,187,ZUERICH,1122839,546198,576641,938650,442059,496591,184189,104139,80050,836,164,1
42,134 HUETTEN,618,309,309,605,302,303,13,7,6,979,21,ZUERICH,1122839,546198,576641,938650,442059,496591,184189,104139,80050,836,164,1
43,135 KILCHBERG (ZH),7214,3272,3942,6238,2789,3449,976,483,493,865,135,ZUERICH,1122839,546198,576641,938650,442059,496591,184189,104139,80050,836,164,1
44,136 LANGHAU AM ALBIS,6694,3327,3367,5719,2779,2940,975,548,427,854,146,ZUERICH,1122839,546198,576641,938650,442059,496591,184189,104139,80050,836,164,1
45,137 OBERRIEDEN,3979,1937,2042,3603,1718,1885,376,219,157,906,94,ZUERICH,1122839,546198,576641,938650,442059,496591,184189,104139,80050,836,164,1
46,138 RICHTERSWIL,8672,4249,4423,7419,3520,3899,1253,729,524,856,144,ZUERICH,1122839,546198,576641,938650,442059,496591,184189,104139,80050,836,164,1
47,139 RUESCHLIKON,4778,2244,2534,4189,1936,2253,589,308,281,877,123,ZUERICH,1122839,546198,576641,938650,442059,496591,184189,104139,80050,836,164,1
48,140 SCHOENENBERG (ZH),1350,705,645,1327,688,639,23,17,6,983,17,ZUERICH,1122839,546198,576641,938650,442059,496591,184189,104139,80050,836,164,1
49,141 THALWIL,15412,7382,8030,12829,5911,6918,2583,1471,1112,832,168,ZUERICH,1122839,546198,576641,938650,442059,496591,184189,104139,80050,836,164,1
50,142 WAEDENSWIL,18485,9105,9380,15367,7359,8008,3118,1746,1372,831,169,ZUERICH,1122839,546198,576641,938650,442059,496591,184189,104139,80050,836,164,1
52,151 ERLENBACH (ZH),4331,2051,2280,3724,1710,2014,607,341,266,860,140,ZUERICH,1122839,546198,576641,938650,442059,496591,184189,104139,80050,836,164,1
53,152 HERRLIBERG,4211,2019,2192,3778,1783,1995,433,236,197,897,103,ZUERICH,1122839,546198,576641,938650,442059,496591,184189,104139,80050,836,164,1
54,153 HOMBRECHTIKON,6001,3045,2956,5305,2633,2672,696,412,284,884,116,ZUERICH,1122839,546198,576641,938650,442059,496591,184189,104139,80050,836,164,1
55,154 KUESNACHT (ZH),12766,5810,6956,11158,4969,6189,1608,841,767,874,126,ZUERICH,1122839,546198,576641,938650,442059,496591,184189,104139,80050,836,164,1
56,155 MAENNEDORF,7833,3715,4118,6634,3060,3574,1199,655,544,847,153,ZUERICH,1122839,546198,576641,938650,442059,496591,184189,104139,80050,836,164,1
57,156 MEILEN,10430,4984,5446,9167,4304,4863,1263,680,583,879,121,ZUERICH,1122839,546198,576641,938650,442059,496591,184189,104139,80050,836,164,1
58,157 OETWIL AM SEE,3247,1636,1611,2549,1223,1326,698,413,285,785,215,ZUERICH,1122839,546198,576641,938650,442059,496591,184189,104139,80050,836,164,1
59,158 STAEFA,10558,5086,5472,9046,4229,4817,1512,857,655,857,143,ZUERICH,1122839,546198,576641,938650,442059,496591,184189,104139,80050,836,164,1
60,159 UETIKON AM SEE,3686,1719,1967,3152,1422,1730,534,297,237,855,145,ZUERICH,1122839,546198,576641,938650,442059,496591,184189,104139,80050,836,164,1
61,160 ZUMIKON,4408,2158,2250,3864,1857,2007,544,301,243,877,123,ZUERICH,1122839,546198,576641,938650,442059,496591,184189,104139,80050,836,164,1
62,69 WALLISELLEN,10887,5493,5394,9076,4337,4739,1811,1156,655,834,166,ZUERICH,1122839,546198,576641,938650,442059,496591,184189,104139,80050,836,164,1
0,171 BAUMA,3010,1530,1480,2606,1303,1303,404,227,177,866,134,ZUERICH,1122839,546198,576641,938650,442059,496591,184189,104139,80050,836,164,1
1,172 FEHRALTORF,2486,1316,1170,2122,1076,1046,364,240,124,854,146,ZUERICH,1122839,546198,576641,938650,442059,496591,184189,104139,80050,836,164,1
2,173 HITTNAU,1347,714,633,1239,646,593,108,68,40,920,80,ZUERICH,1122839,546198,576641,938650,442059,496591,184189,104139,80050,836,164,1
3,174 ILLNAU—EFFRETIKON,14788,7395,7393,12077,5864,6213,2711,1531,1180,817,183,ZUERICH,1122839,546198,576641,938650,442059,496591,184189,104139,80050,836,164,1
4,175 KYBURG,303,154,149,295,151,144,8,3,5,974,26,ZUERICH,1122839,546198,576641,938650,442059,496591,184189,104139,80050,836,164,1
5,176 LINDAU,3132,1696,1436,2664,1419,1245,468,277,191,851,149,ZUERICH,1122839,546198,576641,938650,442059,496591,184189,104139,80050,836,164,1
6,177 PFAEFFIKON,8306,4053,4253,6945,3310,3635,1361,743,618,836,164,ZUERICH,1122839,546198,576641,938650,442059,496591,184189,104139,80050,836,164,1
7,178 RUSSIKON,2810,1410,1400,2542,1263,1279,268,147,121,905,95,ZUERICH,1122839,546198,576641,938650,442059,496591,184189,104139,80050,836,164,1
8,179 STERNENBERG,273,142,131,265,136,129,8,6,2,971,29,ZUERICH,1122839,546198,576641,938650,442059,496591,184189,104139,80050,836,164,1
9,180 WEISSLINGEN,1902,990,912,1721,883,838,181,107,74,905,95,ZUERICH,1122839,546198,576641,938650,442059,496591,184189,104139,80050,836,164,1
10,181 WILA,1242,635,607,1131,570,561,111,65,46,911,89,ZUERICH,1122839,546198,576641,938650,442059,496591,184189,104139,80050,836,164,1
11,182 WILDBERG,650,345,305,640,335,305,10,10,—,985,15,ZUERICH,1122839,546198,576641,938650,442059,496591,184189,104139,80050,836,164,1
13,191 DUEBENDORF,20683,10349,10334,16636,8049,8587,4047,2300,1747,804,196,ZUERICH,1122839,546198,576641,938650,442059,496591,184189,104139,80050,836,164,1
14,192 EGG,6074,2927,3147,5283,2512,2771,791,415,376,870,130,ZUERICH,1122839,546198,576641,938650,442059,496591,184189,104139,80050,836,164,1
15,193 FAELLANDEN,6222,3163,3059,5307,2634,2673,915,529,386,853,147,ZUERICH,1122839,546198,576641,938650,442059,496591,184189,104139,80050,836,164,1
16,194 GREIFENSEE,5423,2694,2729,4774,2332,2442,649,362,287,880,120,ZUERICH,1122839,546198,576641,938650,442059,496591,184189,104139,80050,836,164,1
17,195 MAUR,6222,3095,3127,5579,2745,2834,643,350,293,897,103,ZUERICH,1122839,546198,576641,938650,442059,496591,184189,104139,80050,836,164,1
18,196 MOENCHALTORF,2863,1481,1382,2540,1299,1241,323,182,141,887,113,ZUERICH,1122839,546198,576641,938650,442059,496591,184189,104139,80050,836,164,1
19,197 SCHWERZENBACH,2810,1414,1396,2356,1153,1203,454,261,193,838,162,ZUERICH,1122839,546198,576641,938650,442059,496591,184189,104139,80050,836,164,1
20,198 USTER,23702,11632,12070,18652,8797,9855,5050,2835,2215,787,213,ZUERICH,1122839,546198,576641,938650,442059,496591,184189,104139,80050,836,164,1
21,199 VOLKETSWIL,10033,5071,4962,8394,4076,4318,1639,995,644,837,163,ZUERICH,1122839,546198,576641,938650,442059,496591,184189,104139,80050,836,164,1
22,200 WANGEN—BRUETTISELLEN,3474,1771,1703,2677,1333,1344,797,438,359,771,229,ZUERICH,1122839,546198,576641,938650,442059,496591,184189,104139,80050,836,164,1
24,211 ALTIKON,437,220,217,434,217,217,3,3,—,993,7,ZUERICH,1122839,546198,576641,938650,442059,496591,184189,104139,80050,836,164,1
25,212 BERTSCHIKON,738,356,382,715,342,373,23,14,9,969,31,ZUERICH,1122839,546198,576641,938650,442059,496591,184189,104139,80050,836,164,1
26,213 BRUETTEN,1153,573,580,1090,539,551,63,34,29,945,55,ZUERICH,1122839,546198,576641,938650,442059,496591,184189,104139,80050,836,164,1
27,714 DAFf1FRIFN,485,262,223,473,255,210,12,7,5,975,25,ZUERICH,1122839,546198,576641,938650,442059,496591,184189,104139,80050,836,164,1
28,215 DAETTLIKON,426,225,201,414,216,198,12,9,3,972,28,ZUERICH,1122839,546198,576641,938650,442059,496591,184189,104139,80050,836,164,1
29,216 DINHARD,979,492,487,962,479,483,17,13,4,983,17,ZUERICH,1122839,546198,576641,938650,442059,496591,184189,104139,80050,836,164,1
30,217 ELGG,3041,1527,1514,2578,1260,1318,463,267,196,848,152,ZUERICH,1122839,546198,576641,938650,442059,496591,184189,104139,80050,836,164,1
31,218 ELLIKON AN DER THUR,533,282,251,490,257,233,43,25,18,919,81,ZUERICH,1122839,546198,576641,938650,442059,496591,184189,104139,80050,836,164,1
32,219 ELSAU,2558,1306,1252,2389,1203,1186,169,103,66,934,66,ZUERICH,1122839,546198,576641,938650,442059,496591,184189,104139,80050,836,164,1
33,220 HAGENBUCH,568,308,260,548,298,250,20,10,10,965,35,ZUERICH,1122839,546198,576641,938650,442059,496591,184189,104139,80050,836,164,1
34,221 HETTLINGEN,1379,689,690,1325,656,669,54,33,21,961,39,ZUERICH,1122839,546198,576641,938650,442059,496591,184189,104139,80050,836,164,1
35,222 HOFSTETTEN BEI ELGG,337,168,169,334,167,167,3,1,2,991,9,ZUERICH,1122839,546198,576641,938650,442059,496591,184189,104139,80050,836,164,1
36,223 NEFTENBACH,2572,1304,1268,2413,1205,1208,159,99,60,938,62,ZUERICH,1122839,546198,576641,938650,442059,496591,184189,104139,80050,836,164,1
37,224 PFUNGEN,2122,1087,1035,1633,816,817,489,271,218,770,230,ZUERICH,1122839,546198,576641,938650,442059,496591,184189,104139,80050,836,164,1
38,225 RICKENBACH (ZH),1667,869,798,1507,781,726,160,88,72,904,96,ZUERICH,1122839,546198,576641,938650,442059,496591,184189,104139,80050,836,164,1
39,226 SCHLATT,509,278,231,488,263,225,21,15,6,959,41,ZUERICH,1122839,546198,576641,938650,442059,496591,184189,104139,80050,836,164,1
40,227 SEUZACH,4659,2326,2333,4183,2049,2134,476,277,199,898,102,ZUERICH,1122839,546198,576641,938650,442059,496591,184189,104139,80050,836,164,1
41,228 TURBENTHAL,2975,1532,1443,2381,1192,1189,594,340,254,800,200,ZUERICH,1122839,546198,576641,938650,442059,496591,184189,104139,80050,836,164,1
42,229 WIESENDANGEN,3051,1535,1516,2879,1428,1451,172,107,65,944,56,ZUERICH,1122839,546198,576641,938650,442059,496591,184189,104139,80050,836,164,1
43,230 WINTERTHUR,86758,42184,44574,70824,33141,37683,15934,9043,6891,816,184,ZUERICH,1122839,546198,576641,938650,442059,496591,184189,104139,80050,836,164,1
44,231 ZELL (ZH),4138,2071,2067,3398,1667,1731,740,404,336,821,179,ZUERICH,1122839,546198,576641,938650,442059,496591,184189,104139,80050,836,164,1
46,241 AESCH B.BIRMENSDORF,788,405,383,765,388,377,23,17,6,971,29,ZUERICH,1122839,546198,576641,938650,442059,496591,184189,104139,80050,836,164,1
47,242 BIRMENSDORF (ZH),4097,2048,2049,3738,1830,1908,359,218,141,912,88,ZUERICH,1122839,546198,576641,938650,442059,496591,184189,104139,80050,836,164,1
48,243 DIETIKON,21765,10823,10942,16449,7887,8562,5316,2936,2380,756,244,ZUERICH,1122839,546198,576641,938650,442059,496591,184189,104139,80050,836,164,1
49,244 GEROLDSWIL,3925,1976,1949,3427,1676,1751,498,300,198,873,127,ZUERICH,1122839,546198,576641,938650,442059,496591,184189,104139,80050,836,164,1
50,245 OBERENGSTRINGEN,6154,2997,3157,5329,2541,2788,825,456,369,866,134,ZUERICH,1122839,546198,576641,938650,442059,496591,184189,104139,80050,836,164,1
51,246 OETWIL AN DER LIMMAT,1399,720,679,1248,622,626,151,98,53,892,108,ZUERICH,1122839,546198,576641,938650,442059,496591,184189,104139,80050,836,164,1
52,247 SCHLIEREN,12891,6453,6438,9645,4443,5202,3246,2010,1236,748,252,ZUERICH,1122839,546198,576641,938650,442059,496591,184189,104139,80050,836,164,1
53,248 UITIKON,2763,1397,1366,2498,1256,1242,265,141,124,904,96,ZUERICH,1122839,546198,576641,938650,442059,496591,184189,104139,80050,836,164,1
54,249 UNTERENGSTRINGEN,2290,1137,1153,1996,958,1038,294,179,115,872,128,ZUERICH,1122839,546198,576641,938650,442059,496591,184189,104139,80050,836,164,1
55,250 URDORF,8589,4245,4344,7524,3647,3877,1065,598,467,876,124,ZUERICH,1122839,546198,576641,938650,442059,496591,184189,104139,80050,836,164,1
56,251 WEININGEN (ZH),3054,1561,1493,2539,1262,1277,515,299,216,831,169,ZUERICH,1122839,546198,576641,938650,442059,496591,184189,104139,80050,836,164,1
57,252 ZOLLIKON,12134,5487,6647,10591,4688,5903,1543,799,744,873,127,ZUERICH,1122839,546198,576641,938650,442059,496591,184189,104139,80050,836,164,1
58,253 ZUERICH,369522,172041,197481,304214,136113,168101,65308,35928,29380,823,177,ZUERICH,1122839,546198,576641,938650,442059,496591,184189,104139,80050,836,164,1
